20
11111111111111111111
10000000000100010001
10001011110100010101
11111010010100010101
10001010010110010101
10101010010100010101
10101010010100010101
10100010000100010100
10111110000000010100
10100010000000010100
10001010000000010111
11111000000000010001
10001010000000011001
10101111000000001001
10100001100111111001
10110000000100000001
10010000010101111111
11011111110100000001
10000000000000000001
11111111111111111111